2,2,2,2,2,2,2,2,2,2,2
2,0,0,0,0,0,0,0,0,0,2
2,0,2,2,2,2,2,2,2,0,2
2,0,2,0,0,0,0,0,2,0,2
2,0,2,0,1,5,3,0,2,0,2
2,0,2,2,0,5,0,0,2,2,2
2,0,0,2,0,3,0,0,0,0,2
2,0,0,2,0,0,0,2,2,2,2
2,2,2,2,2,2,2,2,2,2,2
